NO ./texture/xpm/blue_wall.xpm
SO ./texture/xpm/brick_wall.xpm
WE ./texture/xpm/grey_wall.xpm
EA ./texture/xpm/steel_wall.xpm

C 0,255,0
F 255,255,0

       1111 1111 1111
      1000010000100001
      1000000000000001
       10000001000001
      1000000010000001
     10000000E000000001
     100000000000000001
     100000001000000001
    100000001 1000000001
    100000001 1000000001
     100000001000000001
      1000000000000001
       1111110111111
             1