NO ./texture/xpm/space/red.xpm
SO ./texture/xpm/space/green.xpm
WE ./texture/xpm/space/red.xpm
EA ./texture/xpm/space/green.xpm

C 0,0,0
F 0,0,0

11111111111111111111
10000000000000000001
10000000000000000001
100000000E0000000001
10000000000000000001
10000000000000000001
10000000000000000001
11111111111111111111