NO ./texture/xpm/blue_wall.xpm
SO ./texture/xpm/brick_wall.xpm
WE ./texture/xpm/grey_wall.xpm
EA ./texture/xpm/steel_wall.xpm

C 0,255,255
F 160,160,160

11111111111111111111
10000000000000000001
100000000W0000000001
10000000000000000001
11111111111111111111