NO ./texture/xmp/blue_wall.xpm
SO ./texture/xmp/brick_wall.xpm
WE ./texture/xmp/grey_wall.xpm
EA ./texture/xmp/steel_wall.xpm

C 0,255,255
F 160,160,160

11111111
10001101
11000011
11000011
10100001
10000001
100N0001
11111111