NO ./texture/xmp/blue_wall.xpm
SO ./texture/xmp/brick_wall.xpm
WE ./texture/xmp/grey_wall.xpm
EA ./texture/xmp/steel_wall.xpm

C 0,255,255
F 160,160,160

11111
10001
10001
1N001
11111