SO ./texture/xpm/backrooms/pools/pool_wall.xpm
NO ./texture/xpm/backrooms/pools/pool_wall.xpm
WE ./texture/xpm/backrooms/pools/pool.xpm
EA ./texture/xpm/backrooms/pools/pool.xpm

C 255,255,255
F 239,238,226

1111111111111111111111111
1000000000000000000000001
1000000000000000000000001
1000000000000000000000001
1000000000000000000000001
100000000000N000000000001
1000000000000000000000001
1000000000000000000000001
1000000000000000000000001
1111111111111111111111111
